111111111111111111111111111111111
10000000000000000000000000000001
100000000000000000000000000000001
1000000000000000000000001
1111111111111111111111111
