111111111111111111111111111111111111111111111111
1P01000000000010000000000000010000000000C0000001
100100000000001000000C00000001000000000000000001
100100000000001000000000000001000000111111111111
1000000010000000000000100000000000001000000000E1
1000000010000C00000000100000000C0000100000000001
100000001000000000000010000000000000000000000001
111111111111111111111111111111111111111111111111
