1111111111111111111
1P010000C0100000001
100100100010001C001
1000001E00000010001
1111111111111111111
