11111111111111111111111111111111
1P0100000010C0100000000000000001
1001000000100010010000000000C001
10010000000000100111100001111111
10000000100000100000100001000001
1000000010000C000000100001000001
1111111110011111111110000100E001
10010000000000000000000001000001
10010000111111110000000001011111
1C000000100000010000100000000001
1111100011111C01000010000C000001
1C000000000000010000100000000001
11111111111111111111111111111111
