11111111111111111111111111111111
1P010000000000100000000000000001
10010000000000100000000000000001
10010000000000100000000000011111
100000001000000000001000000000E1
10000000100000000000100000000001
10000000100000000000100000000001
11111111111111111111111111111111
