11111111111111111111111111111111
1P0100000000001000000000C0000001
10010000000000100000000000000001
10010000000000100000000000011111
10000000100000000000100000000001
1000000010000C000000100000000001
10000000100000000000100000000001
11111111111111111111111111111111
